222222222222222222222222222223222222
232323232232322223222223232323222222
232323232232322223222223232323222222
232323232232322223222223232323222222
232322222222222233333223232223222222
222222222222222222222222222223222222
223323232232322222222222332323222222
222222232222222222222222222223222222
222223232222222222222222222223222222
232323232232322233333223232323222222
232323232232322232232223232333222222
232323232232322232232223232323222222
232323232232322232232223232223222222
222222222222222232232222222223222222


