222222222222222222222222222222222222
232323232232322222222223232323222222
232323232232322222222223232323222222
232323232232322222222223232323222222
232322222222222333333223232222222222
222222222222222322223222222222222222
223323232232322322223222332323222222
222222222222222322223222222222222222
222222222222222322223222222222222222
232323232232322333333223232323222222
232323332233322232232223232333222222
232323232232322232232223232323222222
232322222222222232232223232222222222
222222222222222232232222222222222222
