222222222222222222222222232222222222
232323232232322222222222232323222222
222223232232322222222222232322222222
233323232232322222222222232323222222
232322222222222222222222232322222222
232322222222222322223222232223222222
223323232232322322223222332222222222
222222222222222322223222232223222222
222322222222222322223222232222222222
232323232232322222222223232223222222
222222222233322232232223232222222222
232323232232322232232223232223222222
232322222222222232232223232222222222
222222222222222232232222222223222222
